2x2
1, 1, 1, 1, 1, 1, 1, 5, 1, 1, 1, 1, 1, 1, 1, 1, 
1, 8, 1, 1, 1, 1, 5, 5, 1, 5, 1, 1, 1, 1, 1, 1, 
5, 5, 1, 5, 1, 5, 8, 8, 8, 8, 5, 1, 1, 1, 1, 1, 
8, 1, 1, 1, 8, 5, 5, 1, 5, 5, 5, 1, 1, 16, 16, 16, 
1, 16, 1, 1, 1, 1, 1, 1, 1, 5, 1, 5, 1, 1, 16, 1, 
16, 16, 16, 16, 16, 1, 1, 1, 1, 5, 5, 5, 1, 1, 1, 1, 
1, 16, 16, 16, 16, 16, 16, 1, 1, 5, 5, 1, 1, 1, 1, 16, 
1, 16, 16, 1, 16, 16, 16, 1, 1, 1, 5, 1, 1, 1, 16, 16, 
1, 1, 1, 5, 1, 1, 16, 1, 1, 1, 5, 5, 1, 16, 16, 1, 
1, 1, 5, 1, 1, 1, 16, 16, 1, 1, 8, 8, 1, 1, 16, 1, 
1, 5, 5, 5, 5, 1, 1, 1, 16, 1, 5, 5, 1, 1, 1, 1, 
1, 5, 5, 5, 8, 1, 16, 1, 16, 1, 5, 5, 5, 1, 1, 1, 
5, 1, 1, 1, 5, 1, 1, 1, 1, 1, 5, 5, 5, 1, 1, 16, 
1, 1, 1, 1, 1, 1, 1, 1, 1, 5, 1, 1, 1, 1, 1, 1, 
1, 1, 16, 16, 16, 16, 5, 5, 5, 8, 5, 5, 1, 1, 1, 1, 
1, 1, 16, 1, 16, 16, 1, 1, 8, 5, 5, 1, 1, 5, 1, 5, 
